BinLocation = d.BinLocation,
                                       BuydownPrice = d.BuydownPrice,
                                       BuydownQuantity = d.BuydownQuantity,
                                       CommissionAmount = d.CommissionAmount,
                                       CommissionMaximum = d.CommissionMaximum,
                                       CommissionMode = d.CommissionMode,
                                       CommissionPercentProfit = d.CommissionPercentProfit,
                                       CommissionPercentSale = d.CommissionPercentSale,
                                       Description = d.Description,
                                       FoodStampable = d.FoodStampable,
                                       HQID = d.HQID,
                                       ItemNotDiscountable = d.ItemNotDiscountable,
                                       LastReceived = d.LastReceived,
                                       LastUpdated = d.LastUpdated,
                                       Notes = d.Notes,
                                       QuantityCommitted = d.QuantityCommitted,
                                       SerialNumberCount = d.SerialNumberCount,
                                       TareWeightPercent = d.TareWeightPercent,
                                       ID = d.ID,
                                       ItemLookupCode = d.ItemLookupCode,
                                       DepartmentID = d.DepartmentID,
                                       CategoryID = d.CategoryID,
                                       MessageID = d.MessageID,
                                       Price = d.Price,
                                       PriceA = d.PriceA,
                                       PriceB = d.PriceB,
                                       PriceC = d.PriceC,
                                       SalePrice = d.SalePrice,
                                       SaleStartDate = d.SaleStartDate,
                                       SaleEndDate = d.SaleEndDate,
                                       QuantityDiscountID = d.QuantityDiscountID,
                                       TaxID = d.TaxID,
                                       ItemType = d.ItemType,
                                       Cost = d.Cost,
                                       Quantity = d.Quantity,
                                       ReorderPoint = d.ReorderPoint,
                                       RestockLevel = d.RestockLevel,
                                       TareWeight = d.TareWeight,
                                       SupplierID = d.SupplierID,
                                       TagAlongItem = d.TagAlongItem,
                                       TagAlongQuantity = d.TagAlongQuantity,
                                       ParentItem = d.ParentItem,
                                       ParentQuantity = d.ParentQuantity,
                                       BarcodeFormat = d.BarcodeFormat,
                                       PriceLowerBound = d.PriceLowerBound,
                                       PriceUpperBound = d.PriceUpperBound,
                                       PictureName = d.PictureName,
                                       LastSold = d.LastSold,
                                       ExtendedDescription = d.ExtendedDescription,
                                       SubDescription1 = d.SubDescription1,
                                       SubDescription2 = d.SubDescription2,
                                       SubDescription3 = d.SubDescription3,
                                       UnitOfMeasure = d.UnitOfMeasure,
                                       SubCategoryID = d.SubCategoryID,
                                       QuantityEntryNotAllowed = d.QuantityEntryNotAllowed,
                                       PriceMustBeEntered = d.PriceMustBeEntered,
                                       BlockSalesReason = d.BlockSalesReason,
                                       BlockSalesAfterDate = d.BlockSalesAfterDate,
                                       Weight = d.Weight,
                                       Taxable = d.Taxable,
                                       DBTimeStamp = d.DBTimeStamp,
                                       BlockSalesBeforeDate = d.BlockSalesBeforeDate,
                                       LastCost = d.LastCost,
                                       ReplacementCost = d.ReplacementCost,
                                       WebItem = d.WebItem,
                                       BlockSalesType = d.BlockSalesType,
                                       BlockSalesScheduleID = d.BlockSalesScheduleID,
                                       SaleType = d.SaleType,
                                       SaleScheduleID = d.SaleScheduleID,
                                       Consignment = d.Consignment,
                                       Inactive = d.Inactive,
                                       LastCounted = d.LastCounted,
                                       DoNotOrder = d.DoNotOrder,
                                       MSRP = d.MSRP,
                                       DateCreated = d.DateCreated,
                                       Content = d.Content,
                                       UsuallyShip = d.UsuallyShip,
                                       NumberFormat = d.NumberFormat,
                                       ItemCannotBeRet = d.ItemCannotBeRet,
                                       ItemCannotBeSold = d.ItemCannotBeSold,
                                       IsAutogenerated = d.IsAutogenerated,
                                       IsGlobalvoucher = d.IsGlobalvoucher,
                                       DeleteZeroBalanceEntry = d.DeleteZeroBalanceEntry,
                                       TenderID = d.TenderID,
                                        MinimumOrder_Sup=sup_list.MinimumOrder,
                                         
                                        ItemID_Sup=sup_list.ItemID,
                                         SupplierID_Sup=sup_list.SupplierID,

                                         Cost_Sup=sup_list.Cost,
                                        ReorderNumber_Sup=sup_list.ReorderNumber,
                                        MasterPackQuantity_Sup=sup_list.MasterPackQuantity,
                                        
                                        TaxRate_Sup=sup_list.TaxRate